{
  "ɣ": "4",
  "ɛ": "3",
  "ḥ": "7",
  "x": "5",
  "q": "9",
  "ṭ": "6",
  "ḍ": "9",
  "ṣ": "9",
  "gh": "4",
  "kh": "5",
  "7": "h",
  "9": "q",
  "3": "ɛ",
  "5": "x"
}
